  R 1920 2000
          NO    textures/WALL16.xpm
          SO	textures/WALL75.xpm
          EA textures/WALL85.xpm
         WE textures/grass.xpm
  

	
 S textures/heart.xpm
F 255,128,128
C 179,255,255

        11111111111111
11111111100220000000001     
1111111111000000000000111
10000000000000000000000001
1000001110E00000000000001 1111
100000120010000000000000011121
10200011110000000000000000000011
10000000001100000111111111111111
10000000001100000000000000001
111111111111111110000000002001
               11111111111111111