  R   1920 1080
          NO    textures/WALL16.xpm
          SO	textures/WALL75.xpm
          EA textures/WALL85.xpm
         WE textures/grass.xpm
  

	
 S textures/heart.xpm

F      222,128,111
C 179,255,255


111111111111111111111111111111111
100000000000000000000000000000001     
1000000000000S0000000000000000001
100000002220000000222000000000001     
100000022222000002222200000000001
100000222222222222222220000000001
100002222222222222222222000000001
100000022222222222222200000000001     
100000000022222222220000000000001
100000000000222222000000000000001     
100000000000002200000000000000001
100000000000000000000000000000001 
111111111111111111111111111111111