  R 640 480
          NO textures/WALL16.xpm
          SO textures/WALL75.xpm
          EA textures/WALL85.xpm
         WE textures/grass.xpm


 S textures/grass.xpm
F 255,128,128
C 179,255,255

        1111111111111
11111111100200001     
111111111100000001
100000000000000001
100000111000S00001 11
100000120010000001 101
10200011110000001   1
100000000011000001
100000000011000001
11111111111111111
   
  
11111