R 1920 1080
SO textures/WALL69.xpm
NO textures/WALL69.xpm




WE textures/WALL69.xpm
EA textures/WALL69.xpm

S textures/barrel.xpm
F 213,255,128
C 96,32,32

         111111111
         100200001     
111111111100000001
100000000000000001
100000111000000001 11
100000100010000001 101
10000011110000001   1
100000000011000001
1000000000110S0001
11111111111111111   