R 641 483
NO textures/WALL16.xpm
SO textures/WALL16.xpm
WE textures/WALL16.xpm
EA textures/WALL16.xpm
S textures/knight.xpm
F 77,77,77
C 255,204,255

111111111111111111111111111111111111111111111111111111111111
100002222222222222222222222222222222222222222222222222222221
100002222222222222222222222222222222222222222222222222222221
100002222222222222222222222222222222222222222222222222222221
100002222222222222222222222222222222222222222222222222222221
100002222222222222222222222222222222222222222222222222222221
100002222222222222222222222222222222222222222222222222222221
100002222222222222222222222222222222222222222222222222222221
100002222222222222222222222222222222222222222222222222222221
100002222222222222222222222222222222222222222222222222222221
100002222222222222222222222222222222222222222222222222222221
100002222222222222222222222222222222222222222222222222222221
100002222222222222222222222222222222222222222222222222222221
100002222222222222222222222222222222222222222222222222222221
100002222222222222222222222222222222222222222222222222222221
100002222222222222222222222222222222222222222222222222222221
100002222222222222222222222222222222222222222222222222222221
100002222222222222222222222222222222222222222222222222222221
100002222222222222222222222222222222222222222222222222222221
100002222222222222222222222222222222222222222222222222222221
100002222222222222222222222222222222222222222222222222222221
10E000000000000000000000000000000000000000000000000000022221
100002222222222222222222222222222222222222222222222222222221
100002222222222222222222222222222222222222222222222222222221
100002222222222222222222222222222222222222222222222222222221
100002222222222222222222222222222222222222222222222222222221
100002222222222222222222222222222222222222222222222222222221
100002222222222222222222222222222222222222222222222222222221
100002222222222222222222222222222222222222222222222222222221
100002222222222222222222222222222222222222222222222222222221
100002222222222222222222222222222222222222222222222222222221
100002222222222222222222222222222222222222222222222222222221
100002222222222222222222222222222222222222222222222222222221
100002222222222222222222222222222222222222222222222222222221
100002222222222222222222222222222222222222222222222222222221
100002222222222222222222222222222222222222222222222222222221
100002222222222222222222222222222222222222222222222222222221
100002222222222222222222222222222222222222222222222222222221
100002222222222222222222222222222222222222222222222222222221
100002222222222222222222222222222222222222222222222222222221
100002222222222222222222222222222222222222222222222222222221
100002222222222222222222222222222222222222222222222222222221
100002222222222222222222222222222222222222222222222222222221
100002222222222222222222222222222222222222222222222222222221
100002222222222222222222222222222222222222222222222222222221
100002222222222222222222222222222222222222222222222222222221
111111111111111111111111111111111111111111111111111111111111
 
1111
1001
1001
1111
11111
1000001
11111111