R 1920 1080
NO textures/WALL16.xpm
SO textures/WALL16.xpm
WE textures/WALL16.xpm
EA textures/WALL16.xpm
S textures/grass.xpm

F 213,255,128
C 96,32,32

111111111111111111111111111111111111111111111111111111111111
100002222222222222222222222222222222222222222222222222222221
100002222222222222222222222222222222222222222222222222222221
100002222222222222222222222222222222222222222222222222222221
100002222222222222222222222222222222222222222222222222222221
100002222222222222222222222222222222222222222222222222222221
100002222222222222222222222222222222222222222222222222222221
100002222222222222222222222222222222222222222222222222222221
100002222222222222222222222222222222222222222222222222222221
100002222222222222222222222222222222222222222222222222222221
100002222222222222222222222222222222222222222222222222222221
100002222222222222222222222222222222222222222222222222222221
100002222222222222222222222222222222222222222222222222222221
100002222222222222222222222222222222222222222222222222222221
100002222222222222222222222222222222222222222222222222222221
100002222222222222222222222222222222222222222222222222222221
100002222222222222222222222222222222222222222222222222222221
100002222222222222222222222222222222222222222222222222222221
100002222222222222222222222222222222222222222222222222222221
100002222222222222222222222222222222222222222222222222222221
100002222222222222222222222222222222222222222222222222222221
10E000000000000000000000000000000000000000000000000000022221
100002222222222222222222222222222222222222222222222222222221
100002222222222222222222222222222222222222222222222222222221
100002222222222222222222222222222222222222222222222222222221
100002222222222222222222222222222222222222222222222222222221
100002222222222222222222222222222222222222222222222222222221
100002222222222222222222222222222222222222222222222222222221
100002222222222222222222222222222222222222222222222222222221
100002222222222222222222222222222222222222222222222222222221
100002222222222222222222222222222222222222222222222222222221
100002222222222222222222222222222222222222222222222222222221
100002222222222222222222222222222222222222222222222222222221
100002222222222222222222222222222222222222222222222222222221
100002222222222222222222222222222222222222222222222222222221
100002222222222222222222222222222222222222222222222222222221
100002222222222222222222222222222222222222222222222222222221
100002222222222222222222222222222222222222222222222222222221
100002222222222222222222222222222222222222222222222222222221
100002222222222222222222222222222222222222222222222222222221
100002222222222222222222222222222222222222222222222222222221
100002222222222222222222222222222222222222222222222222222221
100002222222222222222222222222222222222222222222222222222221
100002222222222222222222222222222222222222222222222222222221
100002222222222222222222222222222222222222222222222222222221
100002222222222222222222222222222222222222222222222222222221
111111111111111111111111111111111111111111111111111111111111