R 1920 1080
          NO textures/WALL16.xpm
          SO textures/WALL16.xpm
          EA textures/WALL16.xpm
         WE textures/WALL16.xpm

S textures/sprite
F 77,77,77
C 255,204,255

         111111111
         100200001     
11111111110000000111101
100000000000000001
100000111000S00001 11
100000100010000001 101
100000111100000010  11
100000000011000001
100000000011000001
11111111111111111